Account No,DATE,TRANSACTION DETAILS,CHQ.NO.,VALUE DATE, WITHDRAWAL AMT , DEPOSIT AMT ,BALANCE AMT,.
409000611074',29-Jun-17,TRF FROM  Indiaforensic SERVICES,,29-Jun-17,," 1,000,000.00 "," 1,000,000.00 ",.
409000611074',05-Jul-17,TRF FROM  Indiaforensic SERVICES,,05-Jul-17,," 1,000,000.00 "," 2,000,000.00 ",.
409000611074',18-Jul-17,FDRL/INTERNAL FUND TRANSFE,,18-Jul-17,," 500,000.00 "," 2,500,000.00 ",.
409000611074',01-Aug-17,TRF FRM  Indiaforensic SERVICES,,01-Aug-17,," 3,000,000.00 "," 5,500,000.00 ",.
409000611074',16-Aug-17,FDRL/INTERNAL FUND TRANSFE,,16-Aug-17,," 500,000.00 "," 6,000,000.00 ",.
409000611074',16-Aug-17,FDRL/INTERNAL FUND TRANSFE,,16-Aug-17,," 500,000.00 "," 6,500,000.00 ",.
409000611074',16-Aug-17,FDRL/INTERNAL FUND TRANSFE,,16-Aug-17,," 500,000.00 "," 7,000,000.00 ",.
409000611074',16-Aug-17,FDRL/INTERNAL FUND TRANSFE,,16-Aug-17,," 500,000.00 "," 7,500,000.00 ",.
409000611074',16-Aug-17,FDRL/INTERNAL FUND TRANSFE,,16-Aug-17,," 500,000.00 "," 8,000,000.00 ",.